10 10 2 2 9 9
NA NA -1 /2 +1 NA NA +9 +7 NA
-7 NA *3 NA +2 +1 -1 -7 -5 NA
+4 *2 +8 +3 -7 -1 +4 /1 /3 NA
+9 -2 +5 -1 +9 NA -2 +4 -1 NA
/1 *7 NA NA +4 NA NA -7 -4 /2
NA NA -1 /2 +1 NA NA +9 -9 /2
-7 NA *3 NA +8 +1 -1 -7 *2 NA
+4 *2 -8 +3 -7 -1 +4 +4 /4 +7
+5 +7 *2 -9 -1 +3 *4 *1 +2 NA
NA NA NA NA NA NA -2 +4 -1 *2
