9 9 2 2 8 8
NA NA -1 /2 +1 NA NA +9 +7
-7 NA *3 NA +2 +1 -1 -7 -5
+4 *2 +8 +3 -7 -1 +4 /1 /3
+9 -2 +5 -1 +9 NA -2 +4 -1
/1 *7 NA NA +4 NA NA -7 -4
NA NA -1 /2 +1 NA NA +9 -9
-7 NA *3 NA +8 +1 -1 -7 *2
+4 *2 -8 +3 -7 -1 +4 +4 /4
+5 +7 *2 -9 -1 +3 *4 *1 +2