13 13 2 2 12 12
NA NA NA NA NA NA NA +9 -2 +5 -1 +9 NA
NA NA *3 NA +2 +1 -1 -7 NA NA NA +2 +1
NA *2 +8 +3 -7 -1 +4 /1 *7 NA NA +4 NA
NA -2 +5 -1 +9 NA -2 +4 *2 -8 +3 -7 -1
/1 *7 NA NA +4 NA NA -7 NA *3 NA +7 +4
NA NA -1 /2 +1 NA NA +9 -2 +5 -1 +9 NA
-7 NA *3 NA +8 +1 -1 -7 NA *3 NA +8 +1
+4 *2 -8 +3 -7 -1 +4 +4 *2 -8 +3 -7 -1
+9 -2 +5 -9 +9 NA -2 +9 -2 +5 -9 +9 NA
/1 *7 NA NA +4 NA NA /1 *7 NA NA +4 NA
-7 NA NA NA +2 +1 -1 -7 NA *3 NA +2 NA
+4 *2 +8 +3 -7 -1 +4 /1 *7 NA NA +4 -2