7 7 2 2 6 6
NA NA -1 /2 +1 NA NA
-7 NA *3 NA +2 +1 -1
+4 *2 +8 +3 -7 -1 +4
+9 -2 +5 -1 +9 NA -2
/1 *7 NA NA +4 NA NA
NA NA -1 /2 +1 NA NA
-7 NA *3 NA +8 +1 -1