12 12 2 2 11 11
NA NA -1 /2 +1 NA NA +9 +7 +2 +3 NA
-7 NA *3 NA +2 +1 -1 -7 -5 -3 +5 NA
+4 *2 +8 +3 -7 -1 +4 /1 /3 -4 +5 NA
+9 -2 +5 -1 +9 NA NA +4 -1 *2 -3 +1
/1 *7 NA NA +4 NA NA -7 -4 /2 -3 -3
NA NA NA NA +1 NA NA +9 NA /2 NA NA
-7 NA *3 NA +8 +1 -1 -7 NA +6 NA NA
+4 *2 -8 +3 -7 -1 +4 +4 /4 +7 *4 NA
+4 -2 *8 -3 +7 -1 +4 +8 /2 +7 *4 NA
NA NA NA NA NA NA -2 +4 -1 *2 +3 NA
-1 -4 *2 *4 +5 -9 -8 *2 +1 -3 -1 NA
-2 +1 +1 *3 +1 -3 -7 +2 -4 *5 -2 +4
