11 11 2 2 10 10
NA NA -1 /2 +1 NA NA +9 NA NA NA
-7 NA *3 NA +2 +1 -1 -7 -5 -3 +5
+4 *2 +8 +3 -7 -1 +4 /1 /3 NA +5
+9 -2 +5 -1 +9 NA -2 +4 -1 NA -3
NA NA NA NA +4 NA NA -7 -4 NA -3
NA NA NA NA +1 NA NA +9 -9 NA -4
-7 NA *3 NA +8 +1 -1 -7 *2 NA /2
+4 *2 -8 +3 -7 -1 +4 +4 /4 +7 *4
+5 +7 *2 -9 -1 +3 *4 *1 +2 *1 +1
+9 -2 +5 -1 NA NA -2 +4 -1 *2 +3
NA NA NA NA NA NA NA NA NA -3 -1
