8 8 2 2 7 7
NA NA -1 /2 +1 NA NA +9
-7 NA *3 NA +2 +1 -1 -7
+4 *2 +8 +3 -7 -1 +4 /1
+9 -2 +5 -1 +9 NA -2 +4
/1 *7 NA NA +4 NA NA -7
NA NA -1 /2 +1 NA NA +9
-7 NA *3 NA +8 +1 -1 -7
+4 *2 -8 +3 -7 -1 +4 +4